NO ./assets/NO.xpm    
SO ./assets/SO.xpm
EA ./assets/EA.xpm
WE ./assets/WE.xpm

F 127,140,141
C 37,168,172

11111111111111111111111111
10000000000000000000000001
10000000000000000000000001
10001111000000000011111001
10001001000000000100001001
10010001000000000000001001
10010001000000000000010001
10011111100000000000100001
10000001000000000001000001
10000001000000000011111101
10000000000000N00000000001
10000000000000000000000001
10000000000000000000000001
11111111111111111111111111